1 1 1 1 5 5 1 1 1 1 1 1 1 1 1 1 1 5 5 1 1 1 1 1 0
5 5 5 5 5 5 5 5 5 5 1 1 1 1 1 1 1 1 1 1 1 1 1 1 1
5 5 5 5 5 1 1 1 5 1 1 1 1 1 5 5 5 5 5 5 5 1 1 1 1
1 1 9 5 5 5 1 1 5 1 1 1 1 1 5 5 5 5 5 5 5 1 1 1 1
1 1 1 5 5 5 1 1 5 5 5 1 1 1 5 5 5 5 5 5 5 1 1 1 1
1 1 1 1 1 1 1 1 5 5 5 1 1 1 1 1 1 1 1 1 1 1 1 8 1
1 1 1 1 1 1 1 1 5 5 5 1 1 1 5 5 5 5 5 5 5 1 1 1 1
5 5 5 5 5 5 5 1 5 1 1 1 1 1 1 1 1 1 1 1 1 1 1 1 1
1 1 1 1 1 1 1 1 1 1 5 1 1 1 1 1 1 1 1 1 1 1 1 1 5
1 1 1 1 1 1 1 1 1 1 5 1 1 1 1 1 1 1 1 1 1 1 1 5 5
1 1 1 1 1 1 1 1 5 5 5 5 5 1 1 5 5 1 1 1 1 1 5 5 5
1 1 1 1 1 1 1 1 1 1 5 1 1 1 1 5 5 1 1 1 1 5 5 5 5
1 1 1 1 1 1 1 1 1 1 5 1 1 1 1 5 5 1 5 1 1 5 1 1 5
1 1 4 1 5 1 1 1 1 1 1 1 1 1 1 5 5 1 5 1 1 5 1 1 1
1 1 1 1 1 1 1 1 1 1 1 1 1 1 1 5 5 1 5 1 1 5 1 1 1
1 1 1 1 1 1 1 1 1 1 1 1 1 1 1 1 1 1 5 1 1 5 1 1 1
1 1 5 5 5 1 1 1 1 1 1 1 1 1 1 1 1 1 5 1 1 5 1 1 1
1 1 5 5 5 1 5 5 1 1 5 5 5 1 1 1 1 1 5 1 1 1 1 1 1
1 1 5 1 1 1 5 5 1 1 5 5 5 1 1 1 1 1 5 5 5 5 5 5 1
5 5 5 1 1 1 5 5 1 1 5 5 5 1 1 1 1 1 5 5 5 5 1 1 1
5 5 5 1 1 1 5 5 1 1 5 5 5 1 1 1 1 1 5 5 1 1 1 1 1
1 1 1 1 1 1 5 5 1 1 5 5 5 1 1 1 1 1 5 5 1 1 1 1 1
1 1 1 1 1 1 1 1 1 1 5 5 5 1 1 1 1 1 5 5 1 1 1 1 1
1 1 1 1 1 1 1 1 1 1 1 1 1 1 1 1 1 1 5 5 1 1 1 1 1
1 1 1 1 1 1 1 1 1 1 1 1 1 1 1 1 1 1 1 1 1 1 1 1 1